10,10
##########
# #   #  #
#     #  #
# #   #  #
# #####  #
# #   ## #
# #####  #
# #    # #
# #      #
##########